1
  -  ,  -  ,  -  ,  -  ,  -  ,  -  ,  -  ,  -  ,  -  ,  -  ,  -  ,  -  ,  -  ,  -  ,  -  ,  -  ,  -  ,  -  ,  -  ,  -  ,  -  ,  -  ,  -  ,  -  ,  -  ,  -  ,  -  ,  -  ,  -  ,  -
  -  ,  -  ,  -  ,  -  ,  -  ,  -  ,  -  ,  -  ,  -  ,  -  ,  -  ,  -  ,  -  ,  -  ,  -  ,  -  ,  -  ,  -  ,  -  ,  -  ,  -  ,  -  ,  -  ,  -  ,  -  ,  -  ,  -  ,  -  ,  -  ,  -
  -  ,  -  ,  -  ,  -  ,  -  ,  -  ,  -  ,  -  ,  -  ,  -  ,  -  ,  -  ,  -  ,  -  ,  -  ,  -  ,  -  ,  -  ,  -  ,  -  ,  -  ,  -  ,  -  ,  -  ,  -  ,  -  ,  -  ,  -  ,  -  ,  -
  -  ,  -  ,  -  ,  -  ,  b  , is  , you ,  -  ,  -  ,  -  ,  f  ,  is , win ,  -  ,  -  ,  -  ,  -  ,  -  ,  -  ,  -  ,  -  ,  -  ,  -  ,  -  ,  -  ,  -  ,  -  ,  -  ,  -  ,  -
  -  ,  -  ,  -  ,  -  ,  -  ,  -  ,  -  ,  -  ,  -  ,  -  ,  -  ,  -  ,  -  ,  -  ,  -  ,  -  ,  -  ,  -  ,  -  ,  -  ,  -  ,  -  ,  -  ,  -  ,  -  ,  -  ,  -  ,  -  ,  -  ,  -
  -  ,  -  ,  -  ,  -  ,  W  ,  W  ,  W  ,  W  ,  W  ,  W  ,  W  ,  W  ,  W  ,  W  ,  W  ,  -  ,  -  ,  -  ,  -  ,  -  ,  -  ,  -  ,  -  ,  -  ,  -  ,  -  ,  -  ,  -  ,  -  ,  -
  -  ,  -  ,  -  ,  -  ,  -  ,  -  ,  -  ,  -  ,  -  ,  R  ,  -  ,  -  ,  -  ,  -  ,  -  ,  -  ,  -  ,  -  ,  -  ,  -  ,  -  ,  -  ,  -  ,  -  ,  -  ,  -  ,  -  ,  -  ,  -  ,  -
  -  ,  -  ,  -  ,  -  ,  -  ,  -  ,  -  ,  -  ,  -  ,  R  ,  -  ,  -  ,  -  ,  -  ,  -  ,  -  ,  -  ,  -  ,  -  ,  -  ,  -  ,  -  ,  -  ,  -  ,  -  ,  -  ,  -  ,  -  ,  -  ,  -
  -  ,  -  ,  -  ,  -  ,  -  ,  -  ,  B  ,  -  ,  -  ,  R  ,  -  ,  -  ,  -  ,  F  ,  -  ,  -  ,  -  ,  -  ,  -  ,  -  ,  -  ,  -  ,  -  ,  -  ,  -  ,  -  ,  -  ,  -  ,  -  ,  -
  -  ,  -  ,  -  ,  -  ,  -  ,  -  ,  -  ,  -  ,  -  ,  R  ,  -  ,  -  ,  -  ,  -  ,  -  ,  -  ,  -  ,  -  ,  -  ,  -  ,  -  ,  -  ,  -  ,  -  ,  -  ,  -  ,  -  ,  -  ,  -  ,  -
  -  ,  -  ,  -  ,  -  ,  -  ,  -  ,  -  ,  -  ,  -  ,  R  ,  -  ,  -  ,  -  ,  -  ,  -  ,  -  ,  -  ,  -  ,  -  ,  -  ,  -  ,  -  ,  -  ,  -  ,  -  ,  -  ,  -  ,  -  ,  -  ,  -
  -  ,  -  ,  -  ,  -  ,  W  ,  W  ,  W  ,  W  ,  W  ,  W  ,  W  ,  W  ,  W  ,  W  ,  W  ,  -  ,  -  ,  -  ,  -  ,  -  ,  -  ,  -  ,  -  ,  -  ,  -  ,  -  ,  -  ,  -  ,  -  ,  -
  -  ,  -  ,  -  ,  -  ,  -  ,  -  ,  -  ,  -  ,  -  ,  -  ,  -  ,  -  ,  -  ,  -  ,  -  ,  -  ,  -  ,  -  ,  -  ,  -  ,  -  ,  -  ,  -  ,  -  ,  -  ,  -  ,  -  ,  -  ,  -  ,  -
  -  ,  -  ,  -  ,  -  ,  w  , is  ,stop ,  -  ,  -  ,  -  ,  r  ,  is ,push ,  -  ,  -  ,  -  ,  -  ,  -  ,  -  ,  -  ,  -  ,  -  ,  -  ,  -  ,  -  ,  -  ,  -  ,  -  ,  -  ,  -
  -  ,  -  ,  -  ,  -  ,  -  ,  -  ,  -  ,  -  ,  -  ,  -  ,  -  ,  -  ,  -  ,  -  ,  -  ,  -  ,  -  ,  -  ,  -  ,  -  ,  -  ,  -  ,  -  ,  -  ,  -  ,  -  ,  -  ,  -  ,  -  ,  -
  -  ,  -  ,  -  ,  -  ,  -  ,  -  ,  -  ,  -  ,  -  ,  -  ,  -  ,  -  ,  -  ,  -  ,  -  ,  -  ,  -  ,  -  ,  -  ,  -  ,  -  ,  -  ,  -  ,  -  ,  -  ,  -  ,  -  ,  -  ,  -  ,  -
2
  -  ,  -  ,  -  ,  -  ,  -  ,  -  ,  -  ,  -  ,  -  ,  -  ,  -  ,  -  ,  -  ,  -  ,  -  ,  -  ,  -  ,  -  ,  -  ,  -  ,  -  ,  -  ,  -  ,  -  ,  -  ,  -  ,  -  ,  -  ,  -  ,  -
  -  ,  -  ,  -  ,  -  ,  -  ,  -  ,  -  ,  -  ,  -  ,  -  ,  -  ,  -  ,  -  ,  -  ,  -  ,  -  ,  -  ,  -  ,  -  ,  -  ,  -  ,  -  ,  -  ,  -  ,  -  ,  -  ,  -  ,  -  ,  -  ,  -
  -  ,  -  ,  -  ,  -  ,  -  ,  -  ,  -  ,  -  ,  -  ,  -  ,  W  ,  W  ,  W  ,  W  ,  W  ,  W  ,  W  ,  -  ,  -  ,  -  ,  -  ,  -  ,  -  ,  -  ,  -  ,  -  ,  -  ,  -  ,  -  ,  -
  -  ,  -  ,  -  ,  -  ,  -  ,  -  ,  -  ,  -  ,  -  ,  -  ,  W  ,  -  ,  -  ,  -  ,  -  ,  -  ,  W  ,  -  ,  -  ,  -  ,  -  ,  -  ,  -  ,  -  ,  -  ,  -  ,  -  ,  -  ,  -  ,  -
  -  ,  -  ,  -  ,  -  ,  -  ,  -  ,  -  ,  -  ,  -  ,  -  ,  W  ,  -  , is  ,  -  ,  -  ,  -  ,  W  ,  -  ,  -  ,  -  ,  -  ,  -  ,  -  ,  -  ,  -  ,  -  ,  -  ,  -  ,  -  ,  -
  -  ,  -  ,  -  ,  -  ,  -  ,  -  ,  -  ,  -  ,  -  ,  -  ,  W  ,  -  ,  -  ,  -  ,  -  ,  -  ,  W  ,  -  ,  -  ,  -  ,  -  ,  -  ,  -  ,  -  ,  -  ,  -  ,  -  ,  -  ,  -  ,  -
  -  ,  -  ,  -  ,  -  ,  -  ,  -  ,  W  ,  W  ,  W  ,  W  ,  W  ,  -  ,  -  ,  -  ,  win,  -  ,  W  ,  -  ,  -  ,  -  ,  -  ,  -  ,  -  ,  -  ,  -  ,  -  ,  -  ,  -  ,  -  ,  -
  -  ,  -  ,  -  ,  -  ,  -  ,  -  ,  W  ,  -  ,  -  ,  -  ,  -  ,  -  ,  -  ,  -  ,  -  ,  -  ,  W  ,  F  ,  -  ,  -  ,  -  ,  -  ,  -  ,  -  ,  -  ,  -  ,  -  ,  -  ,  -  ,  -
  -  ,  -  ,  -  ,  -  ,  -  ,  -  ,  W  ,  -  ,  f  ,  -  ,  -  ,  -  ,  -  ,  -  ,  -  ,  -  ,  W  ,  -  ,  -  ,  -  ,  -  ,  -  ,  -  ,  -  ,  -  ,  -  ,  -  ,  -  ,  -  ,  -
  -  ,  -  ,  -  ,  -  ,  -  ,  -  ,  W  ,  -  ,  -  ,  -  ,  -  ,  -  ,  -  ,  -  ,  -  ,  -  ,  W  ,  -  ,  -  ,  -  ,  -  ,  -  ,  -  ,  -  ,  -  ,  -  ,  -  ,  -  ,  -  ,  -
  -  ,  -  ,  -  ,  -  ,  -  ,  -  ,  W  ,  W  ,  W  ,  W  ,  W  ,  W  ,  W  ,  W  ,  W  ,  W  ,  W  ,  -  ,  -  ,  -  ,  -  ,  -  ,  -  ,  -  ,  -  ,  -  ,  -  ,  -  ,  -  ,  -
  -  ,  -  ,  -  ,  -  ,  -  ,  -  ,  -  ,  -  ,  -  ,  -  ,  W  ,  -  ,  w  ,  -  ,  -  ,  -  ,  W  ,  -  ,  -  ,  -  ,  -  ,  -  ,  -  ,  -  ,  -  ,  -  ,  -  ,  -  ,  -  ,  -
  -  ,  -  ,  -  ,  -  ,  -  ,  -  ,  -  ,  -  ,  b  ,  -  ,  W  ,  -  , is  ,  -  ,  -  ,  B  ,  W  ,  -  ,  -  ,  -  ,  -  ,  -  ,  -  ,  -  ,  -  ,  -  ,  -  ,  -  ,  -  ,  -
  -  ,  -  ,  -  ,  -  ,  -  ,  -  ,  -  ,  -  , is  ,  -  ,  W  ,  -  , stop,  -  ,  -  ,  -  ,  W  ,  -  ,  -  ,  -  ,  -  ,  -  ,  -  ,  -  ,  -  ,  -  ,  -  ,  -  ,  -  ,  -
  -  ,  -  ,  -  ,  -  ,  -  ,  -  ,  -  ,  -  , you ,  -  ,  W  ,  W  ,  W  ,  W  ,  W  ,  W  ,  W  ,  -  ,  -  ,  -  ,  -  ,  -  ,  -  ,  -  ,  -  ,  -  ,  -  ,  -  ,  -  ,  -
  -  ,  -  ,  -  ,  -  ,  -  ,  -  ,  -  ,  -  ,  -  ,  -  ,  -  ,  -  ,  -  ,  -  ,  -  ,  -  ,  -  ,  -  ,  -  ,  -  ,  -  ,  -  ,  -  ,  -  ,  -  ,  -  ,  -  ,  -  ,  -  ,  -
3
  -  ,  -  ,  -  ,  -  ,  -  ,  -  ,  -  ,  -  ,  -  ,  -  ,  -  ,  -  ,  -  ,  -  ,  -  ,  -  ,  -  ,  -  ,  -  ,  -  ,  -  ,  -  ,  -  ,  -  ,  -  ,  -  ,  -  ,  -  ,  -  ,  -
  -  ,  -  ,  -  ,  -  ,  -  ,  -  ,  -  ,  -  ,  -  ,  -  ,  -  ,  -  ,  -  ,  -  ,  -  ,  -  ,  -  ,  -  ,  -  ,  -  ,  -  ,  -  ,  -  ,  -  ,  -  ,  -  ,  -  ,  -  ,  -  ,  -
  -  ,  -  ,  -  ,  -  ,  -  ,  -  ,  -  ,  -  ,  -  ,  -  ,  F  ,  F  ,  F  ,  F  ,  F  ,  F  ,  F  ,  -  ,  -  ,  -  ,  -  ,  -  ,  -  ,  -  ,  -  ,  -  ,  -  ,  -  ,  -  ,  -
  -  ,  -  ,  -  ,  -  ,  -  ,  -  ,  -  ,  -  ,  -  ,  -  ,  F  ,  -  ,  -  ,  -  ,  -  ,  -  ,  F  ,  -  ,  -  ,  -  ,  -  ,  -  ,  -  ,  -  ,  -  ,  -  ,  -  ,  -  ,  -  ,  -
  -  ,  -  ,  -  ,  -  ,  -  ,  -  ,  -  ,  -  ,  -  ,  -  ,  F  ,  -  , is  ,  -  ,  -  ,  -  ,  F  ,  -  ,  -  ,  -  ,  -  ,  -  ,  -  ,  -  ,  -  ,  -  ,  -  ,  -  ,  -  ,  -
  -  ,  -  ,  -  ,  -  ,  -  ,  -  ,  -  ,  -  ,  -  ,  -  ,  F  ,  -  ,  -  ,  -  ,  -  ,  -  ,  F  ,  -  ,  -  ,  -  ,  -  ,  -  ,  -  ,  -  ,  -  ,  -  ,  -  ,  -  ,  -  ,  -
  -  ,  -  ,  -  ,  -  ,  -  ,  -  ,  F  ,  F  ,  F  ,  F  ,  F  ,  -  ,  -  ,  -  ,  win,  -  ,  F  ,  -  ,  -  ,  -  ,  -  ,  -  ,  -  ,  -  ,  -  ,  -  ,  -  ,  -  ,  -  ,  -
  -  ,  -  ,  -  ,  -  ,  -  ,  -  ,  F  ,  -  ,  -  ,  -  ,  -  ,  -  ,  -  ,  -  ,  -  ,  -  ,  F  ,  -  ,  -  ,  -  ,  -  ,  -  ,  -  ,  -  ,  -  ,  -  ,  -  ,  -  ,  -  ,  -
  -  ,  -  ,  -  ,  -  ,  -  ,  -  ,  F  ,  -  ,  b  ,  -  ,  -  ,  -  ,  -  ,  -  ,  -  ,  -  ,  F  ,  -  ,  -  ,  -  ,  -  ,  -  ,  -  ,  -  ,  -  ,  -  ,  -  ,  -  ,  -  ,  -
  -  ,  -  ,  -  ,  -  ,  -  ,  -  ,  F  ,  -  ,  -  ,  -  ,  -  ,  -  ,  -  ,  -  ,  -  ,  -  ,  F  ,  -  ,  -  ,  -  ,  -  ,  -  ,  -  ,  -  ,  -  ,  -  ,  -  ,  -  ,  -  ,  -
  -  ,  -  ,  -  ,  -  ,  -  ,  -  ,  F  ,  F  ,  F  ,  F  ,  F  ,  F  ,  F  ,  F  ,  F  ,  F  ,  F  ,  -  ,  -  ,  -  ,  -  ,  -  ,  -  ,  -  ,  -  ,  -  ,  -  ,  -  ,  -  ,  -
  -  ,  -  ,  -  ,  -  ,  -  ,  -  ,  -  ,  -  ,  -  ,  -  ,  F  ,  -  ,  f  ,  -  ,  -  ,  -  ,  F  ,  -  ,  -  ,  -  ,  -  ,  -  ,  -  ,  -  ,  -  ,  -  ,  -  ,  -  ,  -  ,  -
  -  ,  -  ,  -  ,  -  ,  -  ,  -  ,  -  ,  -  ,  W  ,  -  ,  F  ,  -  , is  ,  -  ,  -  ,  W  ,  F  ,  -  ,  -  ,  -  ,  -  ,  -  ,  -  ,  -  ,  -  ,  -  ,  -  ,  -  ,  -  ,  -
  -  ,  -  ,  -  ,  -  ,  -  ,  -  ,  -  ,  -  , is  ,  -  ,  F  ,  -  , stop,  -  ,  -  ,  -  ,  F  ,  -  ,  -  ,  -  ,  -  ,  -  ,  -  ,  -  ,  -  ,  -  ,  -  ,  -  ,  -  ,  -
  -  ,  -  ,  -  ,  -  ,  -  ,  -  ,  -  ,  -  , you ,  -  ,  F  ,  F  ,  F  ,  F  ,  F  ,  F  ,  F  ,  -  ,  -  ,  -  ,  -  ,  -  ,  -  ,  -  ,  -  ,  -  ,  -  ,  -  ,  -  ,  -
  -  ,  -  ,  -  ,  -  ,  -  ,  -  ,  -  ,  -  ,  -  ,  -  ,  -  ,  -  ,  -  ,  -  ,  -  ,  -  ,  -  ,  -  ,  -  ,  -  ,  -  ,  -  ,  -  ,  -  ,  -  ,  -  ,  -  ,  -  ,  -  ,  -
4
  b  ,  w  ,  W  ,  -  ,  -  ,  -  ,  -  ,  -  ,  -  ,  -  ,  -  ,  -  ,  -  ,  -  ,  -  ,  -  ,  -  ,  -  ,  -  ,  -  ,  -  ,  -  ,  -  ,  -  ,  -  ,  -  ,  -  ,  -  ,  -  ,  -
  is , is  ,  W  ,  -  ,  -  ,  -  ,  -  ,  W  ,  W  ,  W  ,  W  ,  W  ,  W  ,  W  ,  W  ,  -  ,  -  ,  -  ,  -  ,  -  ,  -  ,  -  ,  -  ,  -  ,  -  ,  -  ,  -  ,  -  ,  -  ,  -
  you, stop,  W  ,  -  ,  -  ,  -  ,  -  ,  W  ,  -  ,  -  ,  -  ,  -  ,  -  ,  -  ,  W  ,  -  ,  -  ,  -  ,  -  ,  -  ,  -  ,  -  ,  -  ,  -  ,  -  ,  -  ,  -  ,  -  ,  -  ,  -
  W  ,  W  ,  W  ,  -  ,  -  ,  -  ,  -  ,  W  ,  -  ,  B  ,  -  ,  -  ,  R  ,  -  ,  W  ,  -  ,  -  ,  -  ,  -  ,  -  ,  -  ,  -  ,  -  ,  -  ,  -  ,  -  ,  -  ,  -  ,  -  ,  -
  -  ,  -  ,  -  ,  -  ,  -  ,  -  ,  -  ,  W  ,  -  ,  -  ,  -  ,  -  ,  -  ,  -  ,  W  ,  -  ,  -  ,  -  ,  -  ,  -  ,  -  ,  -  ,  -  ,  -  ,  -  ,  -  ,  -  ,  -  ,  -  ,  -
  -  ,  -  ,  -  ,  -  ,  -  ,  -  ,  -  ,  W  ,  -  ,  -  ,  -  ,  -  ,  R  ,  -  ,  W  ,  -  ,  -  ,  -  ,  -  ,  -  ,  -  ,  -  ,  -  ,  -  ,  -  ,  -  ,  -  ,  -  ,  -  ,  -
  -  ,  -  ,  -  ,  -  ,  -  ,  -  ,  -  ,  W  ,  -  ,  -  ,  -  ,  -  ,  -  ,  -  ,  W  ,  -  ,  -  ,  -  ,  -  ,  -  ,  -  ,  -  ,  -  ,  -  ,  -  ,  -  ,  -  ,  -  ,  -  ,  -
  -  ,  -  ,  -  ,  -  ,  W  ,  W  ,  W  ,  W  ,WATER,WATER,WATER,  W  ,  W  ,  W  ,  W  ,  W  ,  W  ,  W  ,  -  ,  -  ,  -  ,  -  ,  -  ,  -  ,  -  ,  -  ,  -  ,  -  ,  -  ,  -
  -  ,  -  ,  -  ,  -  ,  W  ,  -  ,  -  ,  -  ,  -  ,  -  ,  -  ,  W  ,  -  ,  -  ,  -  ,  -  ,  -  ,  W  ,  -  ,  -  ,  -  ,  -  ,  -  ,  -  ,  -  ,  -  ,  -  ,  -  ,  -  ,  -
  -  ,  -  ,  -  ,  -  ,  W  ,  -  ,  -  ,  -  ,  -  ,  -  ,  -  ,  W  ,  -  ,  r  , is  ,push ,  -  ,  W  ,  -  ,  -  ,  -  ,  -  ,  -  ,  -  ,  -  ,  -  ,  -  ,  -  ,  -  ,  -
  -  ,  -  ,  -  ,  -  ,  W  ,  -  ,  -  ,  -  ,  -  ,  -  ,  -  ,  W  ,  -  ,  -  ,  -  ,  -  ,  -  ,  W  ,  -  ,  -  ,  -  ,  -  ,  -  ,  -  ,  -  ,  -  ,  -  ,  -  ,  -  ,  -
  -  ,  -  ,  -  ,  -  ,  W  ,WATER,WATER,WATER,  -  ,  W  ,  -  ,  -  ,  -  ,  -  ,  -  ,  -  ,  -  ,  W  ,  -  ,  -  ,  -  ,  -  ,  -  ,  -  ,  -  ,  -  ,  -  ,  -  ,  -  ,  -
  -  ,  -  ,  -  ,  -  ,  W  ,WATER,WATER,WATER,  -  ,  -  ,  -  ,  W  ,  -  ,  f  , is  , win ,  -  ,  W  ,  -  ,  -  ,  -  ,  -  ,  -  ,  -  ,  -  ,  -  ,  -  ,  -  ,  -  ,  -
  -  ,  -  ,  -  ,  -  ,  W  ,  F  ,WATER,WATER,  -  ,  -  ,  -  ,  W  ,  -  ,  -  ,  -  ,  -  ,  -  ,  W  ,  -  ,  -  ,  -  ,  -  ,  -  ,  -  ,  -  ,  -  ,  -  ,  -  ,  -  ,  -
  -  ,  -  ,  -  ,  -  ,  W  ,  W  ,  W  ,  W  ,  W  ,  W  ,  W  ,  W  ,  W  ,  W  ,  W  ,  W  ,  W  ,  W  ,  -  ,  -  ,  -  ,  -  ,  -  ,  -  ,  -  ,  -  ,  -  ,  -  ,  -  ,  -
  -  ,  -  ,  -  ,  -  ,  -  ,  -  ,  -  ,  -  ,  -  ,  -  ,  -  ,  -  ,  -  ,  -  ,  -  ,  -  ,  -  ,  -  ,  -  ,  -  ,  -  ,  -  ,  -  ,  -  ,  -  ,  -  ,  -  ,  -  ,  -  ,  -
5
  f  , is  , win ,  -  ,  -  ,  -  ,  -  ,  -  ,  -  ,  -  ,  -  ,  -  ,  -  ,  -  ,  -  ,  -  ,  -  ,  -  ,  -  ,  -  ,  -  ,  -  ,  -  ,  -  ,  -  ,  -  ,  -  ,  -  ,  -  ,  -
  b  , is  , you ,  -  ,  -  ,  -  ,  -  ,  -  ,  -  ,  -  ,  -  ,  -  ,  -  ,  -  ,  -  ,  -  ,  -  ,  -  ,  -  ,  -  ,  -  ,  -  ,  -  ,  -  ,  -  ,  -  ,  -  ,  -  ,  -  ,  -
  -  ,  -  ,  -  ,  -  ,  -  ,  -  ,  -  ,  -  ,  -  ,  -  ,  -  ,  -  ,  -  ,  -  ,  -  ,  -  ,  -  ,  -  ,  -  ,  -  ,  -  ,  -  ,  -  ,  -  ,  -  ,  -  ,  -  ,  -  ,  -  ,  -
  -  ,  -  ,  -  ,  -  ,  -  ,  -  ,  -  ,  -  ,  -  ,  -  ,  -  ,  -  ,  -  ,  S  ,  S  ,  S  ,  S  ,  S  ,  S  ,  S  ,  S  ,  S  ,  S  ,  S  ,  -  ,  -  ,  -  ,  -  ,  -  ,  -
  -  ,  -  ,  -  ,  -  ,  -  ,  -  ,  -  ,  -  ,  -  ,  -  ,  -  ,  -  ,  -  ,  S  ,  -  ,  -  ,  -  ,  -  ,  -  ,  -  ,  -  ,  -  ,  -  ,  S  ,  -  ,  -  ,  -  ,  -  ,  -  ,  -
  -  ,  -  ,  -  ,  -  ,  -  ,  -  ,  -  ,  -  ,  -  ,  -  ,  -  ,  -  ,  -  ,  S  ,  -  ,  s  ,  -  ,  -  ,  -  ,  -  ,  -  ,  -  ,  -  ,  S  ,  -  ,  -  ,  -  ,  -  ,  -  ,  -
  -  ,  -  ,  -  ,  -  ,  -  ,  -  ,  -  ,  -  ,  -  ,  -  ,  -  ,  -  ,  -  ,  S  ,  -  , is  ,  -  ,  -  ,  -  ,  -  ,  -  ,  -  ,  -  ,  S  ,  -  ,  -  ,  -  ,  -  ,  -  ,  -
  -  ,  -  ,  -  ,  -  ,  -  ,  -  ,  -  ,  -  ,  -  ,  -  ,  -  ,  -  ,  -  ,  S  ,  -  ,defeat,  -  ,  -  ,  -  ,  -  ,  -  ,  -  ,  -  ,  S  ,  -  ,  -  ,  -  ,  -  ,  -  ,  -
  -  ,  -  ,  -  ,  -  ,  -  ,  -  ,  -  ,  -  ,  -  ,  -  ,  -  ,  -  ,  -  ,  S  ,  -  ,  -  ,  -  ,  -  ,  -  ,  -  ,  -  ,  -  ,  -  ,  S  ,  -  ,  -  ,  -  ,  -  ,  -  ,  -
  -  ,  -  ,  -  ,  -  ,  -  ,  S  ,  R  ,  S  ,  -  ,  -  ,  -  ,  -  ,  -  ,  S  ,  -  ,  -  ,  -  ,  -  ,  -  ,  -  ,  -  ,  -  ,  -  ,  S  ,  -  ,  -  ,  -  ,  -  ,  -  ,  -
  -  ,  -  ,  -  ,  -  ,  -  ,  S  ,  R  ,  S  ,  -  ,  -  ,  -  ,  -  ,  -  ,  S  ,  -  ,  -  ,  -  ,  -  ,  F  ,  -  ,  -  ,  -  ,  -  ,  S  ,  -  ,  -  ,  -  ,  -  ,  -  ,  -
  -  ,  -  ,  -  ,  S  ,  S  ,  S  ,  R  ,  S  ,  S  ,  S  ,  -  ,  -  ,  -  ,  S  ,  -  ,  -  ,  -  ,  -  ,  -  ,  -  ,  -  ,  -  ,  -  ,  S  ,  -  ,  -  ,  -  ,  -  ,  -  ,  -
  -  ,  -  ,  -  ,  S  ,  -  ,  -  ,  -  ,  -  ,  -  ,  S  ,  -  ,  -  ,  -  ,  S  ,  -  ,  -  ,  -  ,  -  ,  -  ,  -  ,  -  ,  -  ,  -  ,  S  ,  -  ,  -  ,  -  ,  -  ,  -  ,  -
  -  ,  -  ,  -  ,  S  ,  -  ,  -  ,  -  ,  -  ,  -  ,  S  ,  -  ,  -  ,  -  ,  S  ,  S  ,  S  ,  S  ,  S  ,  S  ,  S  ,  S  ,  S  ,  S  ,  S  ,  -  ,  -  ,  -  ,  -  ,  -  ,  -
  -  ,  -  ,  -  ,  S  ,  B  ,  -  ,  -  ,  -  ,  -  ,  S  ,  -  ,  -  ,  -  ,  -  ,  -  ,  -  ,  -  ,  -  ,  -  ,  -  ,  -  ,  -  ,  -  ,  -  ,  -  ,  -  ,  -  ,  -  ,  -  ,  -
  -  ,  -  ,  -  ,  S  ,  -  ,  -  ,  -  ,  -  ,  -  ,  S  ,  -  ,  -  ,  -  ,  -  ,  -  ,  -  ,  -  ,  -  ,  -  ,  -  ,  -  ,  -  ,  -  ,  -  ,  -  ,  -  ,  -  ,  -  ,  -  ,  -
6
  -  ,  -  ,  -  ,  -  ,  -  ,  -  ,  -  ,  -  ,  -  ,  -  ,  -  ,  -  ,  -  ,  -  ,  -  ,  -  ,  -  ,  -  ,  -  ,  -  ,  -  ,  -  ,  -  ,  -  ,  -  ,  -  ,  -  ,  -  ,  -  ,  -
  -  ,  -  ,  -  ,  -  ,  -  ,  -  ,  -  ,  -  ,  -  ,  -  ,  -  ,  -  ,  -  ,  -  ,  -  ,  -  ,  -  ,  -  ,  -  ,  -  ,  -  ,  -  ,  -  ,  -  ,  -  ,  -  ,  -  ,  -  ,  -  ,  -
  -  ,  -  ,  -  ,  -  ,  -  ,  -  ,  -  ,  -  ,  -  ,  -  ,  -  ,  -  ,  -  ,  -  ,  -  ,  -  ,  -  ,  -  ,  -  ,  -  ,  -  ,  -  ,  -  ,  -  ,  -  ,  -  ,  -  ,  -  ,  -  ,  -
  -  ,  -  ,  -  ,  -  ,  -  ,  -  ,  -  ,  -  ,  -  ,  -  ,  -  ,  -  ,  -  ,  -  ,  -  ,  -  ,  -  ,  -  ,  -  ,  -  ,  -  ,  -  ,  -  ,  -  ,  -  ,  -  ,  -  ,  -  ,  -  ,  -
  -  ,  -  ,  -  ,  -  ,  -  ,  -  ,  -  ,  -  ,  -  ,  -  ,  -  ,  -  ,  -  ,  -  ,  -  ,  -  ,  -  ,  -  ,  -  ,  -  ,  -  ,  -  ,  -  ,  -  ,  -  ,  -  ,  -  ,  -  ,  -  ,  -
  -  ,  -  ,  -  ,  -  ,  -  ,  -  ,  -  ,  -  ,  -  ,  -  ,  -  ,  -  ,  -  ,  -  ,  -  ,  -  ,  -  ,  -  ,  -  ,  -  ,  -  ,  -  ,  -  ,  -  ,  -  ,  -  ,  -  ,  -  ,  -  ,  -
  -  ,  -  ,  -  ,  -  ,  -  ,  -  ,  -  ,  -  ,  -  ,  -  ,  -  ,  -  ,  -  ,  -  ,  -  ,  -  ,  -  ,  -  ,  -  ,  -  ,  -  ,  -  ,  -  ,  -  ,  -  ,  -  ,  -  ,  -  ,  -  ,  -
  -  ,  -  ,  -  ,  -  ,  -  ,  -  ,  -  ,  -  ,  -  ,  -  ,  -  ,  -  ,  -  ,  -  ,  -  ,  -  ,  -  ,  -  ,  -  ,  -  ,  -  ,  -  ,  -  ,  -  ,  -  ,  -  ,  -  ,  -  ,  -  ,  -
  -  ,  -  ,  -  ,  -  ,  -  ,  -  ,  -  ,  -  ,  -  ,  -  ,  -  ,  -  ,  -  ,  -  ,  -  ,  -  ,  -  ,  -  ,  -  ,  -  ,  -  ,  -  ,  -  ,  -  ,  -  ,  -  ,  -  ,  -  ,  -  ,  -
  -  ,  -  ,  -  ,  -  ,  -  ,  -  ,  -  ,  -  ,  -  ,  -  ,  -  ,  -  ,  -  ,  -  ,  -  ,  -  ,  -  ,  -  ,  -  ,  -  ,  -  ,  -  ,  -  ,  -  ,  -  ,  -  ,  -  ,  -  ,  -  ,  -
  -  ,  -  ,  -  ,  -  ,  -  ,  -  ,  -  ,  -  ,  -  ,  -  ,  -  ,  -  ,  -  ,  -  ,  -  ,  -  ,  -  ,  -  ,  -  ,  -  ,  -  ,  -  ,  -  ,  -  ,  -  ,  -  ,  -  ,  -  ,  -  ,  -
  -  ,  -  ,  -  ,  -  ,  -  ,  -  ,  -  ,  -  ,  -  ,  -  ,  -  ,  -  ,  -  ,  -  ,  -  ,  -  ,  -  ,  -  ,  -  ,  -  ,  -  ,  -  ,  -  ,  -  ,  -  ,  -  ,  -  ,  -  ,  -  ,  -
  -  ,  -  ,  -  ,  -  ,  -  ,  -  ,  -  ,  -  ,  -  ,  -  ,  -  ,  -  ,  -  ,  -  ,  -  ,  -  ,  -  ,  -  ,  -  ,  -  ,  -  ,  -  ,  -  ,  -  ,  -  ,  -  ,  -  ,  -  ,  -  ,  -
  -  ,  -  ,  -  ,  -  ,  -  ,  -  ,  -  ,  -  ,  -  ,  -  ,  -  ,  -  ,  -  ,  -  ,  -  ,  -  ,  -  ,  -  ,  -  ,  -  ,  -  ,  -  ,  -  ,  -  ,  -  ,  -  ,  -  ,  -  ,  -  ,  -
  -  ,  -  ,  -  ,  -  ,  -  ,  -  ,  -  ,  -  ,  -  ,  -  ,  -  ,  -  ,  -  ,  -  ,  -  ,  -  ,  -  ,  -  ,  -  ,  -  ,  -  ,  -  ,  -  ,  -  ,  -  ,  -  ,  -  ,  -  ,  -  ,  -
  -  ,  -  ,  -  ,  -  ,  -  ,  -  ,  -  ,  -  ,  -  ,  -  ,  -  ,  -  ,  -  ,  -  ,  -  ,  -  ,  -  ,  -  ,  -  ,  -  ,  -  ,  -  ,  -  ,  -  ,  -  ,  -  ,  -  ,  -  ,  -  ,  -